#################################################
#-----------------------------------------------#
#-----------------------------------------------#
#-----------------------------------------------#
#------------#####------------------------------#
#------------#####------------------------------#
#------------#####------------------------------#
#------------#####------------------------------#
#------------#####------------------------------#
#------------#####------#####-------------------#
#-----------------------#####-------------------#
#-----------------------#####-------------------#
#-----------------------#####-------------------#
#-----------------------###########-------------#
#-----------------------###########-------------#
#-----------------------------------------------#
#------------------------##---------------------#
#------------------########---------------------#
#------------------######-----------------------#
#----------------####---------------------------#
#----------------####---------------------------#
#-----------------------------------------------#
#-----------------------------------------------#
#-----------------------------------------------#
#################################################